PPPPPPEPPPDPDPPPPPPPPPPPPP,
P    P   M M            DP,
PK   PPPPPPPPP  U  U     P,
PPP  PPPPPPPPPPPPPPPPPPR P,
PPPR PPPPP               P,
PPP  PCCCC     U S      PP,
PPP  P       U PPPPPPPPPPP,
PPP LPR   PPPPPDDDDD     P,
PPP  P               S   P,
PPP  PP   U         PP   P,
PPP  P    P   UUUUUUPP   P,
PPP  PPPPPPPPPPPPPPPPPR LP,
PPP LP    PPPPPPPPPPPP   P,
PPP            PPPPPPP   P,
PPPU                PPR LP,
PPPPPPPPPP               P,
PPPPPPPPPPPPPPP          P,
PPPPPPPPPPPPPPPPPPPP     P,
PPPPPPPPPPPPPPPPPPPPPPPPP

