PPPPPPPPEPPPPPPPPPPPPPPPP,
PPPPPPPD PPPPPPPPPPPPPPPP,
PPPPPP   PPDPPPR  PPPPPPP,
PD       P        PPPPPPP,
P  US U  P   LPS         ,
PP PPPPPPPP    P  U      ,
PP   LPPPPPR   PPPPPPUUP ,
PP    DPPPP   PPPPPPPPP  ,
PP  P   PPP    P DPP     ,
PP  D    PP U SPU P    SU,
PP U U  SPP PPPPP    UPPP,
PPLP P UPPP    PD  U PPPP,
PP D   PPPP  U P  PPPPPDP,
PP   PPPPPPPPP P PP      ,
PP      PP  LPKP  S   U  ,
PPPPU    P    PP UPPPPP  ,
PPPPP  U   U    PPPPPPP  ,
PPPPPPPP S PS U     S    ,
PPPPPPPPPPPPPPPPPPUPP    