PPPP   PDDDDDDDDP  S   DP,
P K  U PR      LP LPP    ,
PPPR P D       LP   PUU  ,
PPP UP S U  U   LPR PPPU ,
PPPPPPPPPPUUPU  LP  PPPP ,
PD   D   LPPPP  U  UPPPR ,
D  U  U U    PU P  PP    ,
   PU PUPS UUPP P PPP  SU,
  UPPSPPPP PPPP P DPR PPP,
 UPPPPPPPP  RPP P  PR DDD,
 PDPRPPPPP    PS P PR  S ,
 S D DPPPP LPRLP D PR LP ,
PP  U D  P  D LP  UPR LP ,
PPU P  U PUUS  PPPPP U P ,
PPPUPSLP  PPPR    DPPPPP ,
E  PPPRPP  PP  U   DD    ,
PU     DPR PP LP  U      ,
PPR  UU S  PP  PSUP SUUUU,
PPPPUPPPPPPPP PPPPPPPPPPP