PPPPPPEPPPDPDPPPPPPPPPPPPP,
P    P   M M M D   D    DP,
PK   PPPPPPPPP  U   U    P,
PPP  PPPPPPPPPPPPPPPPPPR P,
PPPR PPPPP      D       UP,
PPP  PCCCC     U S      PP,
PPP  P     U U PPPPPPPPPPP,
PPP LPR  LPPPPPDDDDD     P,
PPP  P               S   P,
PPP  PP   U         PP   P,
PPPR P    PUUUUUUUUUPP   P,
PPP  PPPPPPPPPPPPPPPPPR LP,
PPP LP    PPPPPPPPPPPP   P,
PPP            PPPPPPP   P,
PPPU  U             PPR LP,
PPPPPPPPPPU              P,
PPPPPPPPPPPPPPPU         P,
PPPPPPPPPPPPPPPPPPPP     P,
PPPPPPPPPPPPPPPPPPPPPPPPP

