PPPPPPPPPPPPPPPPPPPPPPPPP,
P                       P,
P                       P,
P                       P,
P                       P,
P                       P,
P                       P,
P                       P,
P                       P,
P                       P,
WWWWWWWWWWWWWWWWWWWWWWWWW,
WWWWWWWWWWWWWWWWWWWWWWWWW,
WWWWWWWWWWWWWWWWWWWWWWWWW,
WWWWWWWWWWWWWWWWWWWWWWWWW,
WWWWWWWWWWWWWWWWWWWWWWWWW,
WWWWWWWWWWWWWWWWWWWWWWWWW,
WWWWWWWWWWWWWWWWWWWWWWWWW,
WWWWWWWWWWWWWWWWWWWWWWWWW,
WWWWWWWWWWWWWWWWWWWWWWWWW

