PPPPPPPPEPPPPPPPPPPPPPPPP,
PPPPPPPD PPPPPPPPPPPPPPPP,
PPPD P  LPPDDPPR  PPPPPPP,
PD   D   PR       PPPPPPP,
P  US U  P   LPS  D      ,
PP PPPPPPPP    P U  U  U ,
PP   LPPPPPR  SPPPPPPUUP ,
PPR   DPPPPR LPPPPPPPPPD ,
PP  P  LPPP    P DPPR    ,
PP  D    PP U SPU PR   SU,
PP U UR SPP PLPPP D  UPPP,
PPLP P UPPP   DPD  U PPPP,
PP D S PPPPU U P  PPPPPDP,
PP  LPRPPPPPPP P PP DD  D,
PP     DPP DLPKP  S   U  ,
PPPPR   LP   DPPRUPUPPP  ,
PPPPP SU   U     PPPPDD  ,
PPPPPPPP SUPSU U    S    ,
PPPPPPPPPPPPPPPPPLPUP    