PPPPPPPPEPPPPPPPPPPPPPPPP,
PPPPPPP  PPPPPPPPPPPPPPPP,
PPPPPP  LPPDDPPR  PPPPPPP,
PD       P        PPPPPPP,
P  US U  P   LPS         ,
PP PPPPPPPP    P U  U    ,
PP   LPPPPPR   PPPPPPUUP ,
PP    DPPPPR  PPPPPPPPP  ,
PP  P  LPPP    P DPP     ,
PP  D    PP U SPU PR   SU,
PP U U  SPP PLPPP    UPPP,
PPLP P UPPP    PD  U PPPP,
PP D   PPPP  U P  PPPPPDP,
PP   PRPPPPPPP P PP     D,
PP      PP  LPKP  S   U  ,
PPPPR    P    PP UPUPPP  ,
PPPPP SU   U    PPPPPDD  ,
PPPPPPPP SUPSU      S    ,
PPPPPPPPPPPPPPPPPPPUP    