PPPP   PDDDDDDDDP  S    P,
P K  U P       LP LPP    ,
PPP  P D       LP   PUU  ,
PPPUUP S        LPR PPPU ,
PPPPPPPPPPUUUU  LP  PPPP ,
P         PPPP  U   PPP  ,
D  U  U U    PU P  PP    ,
   PU PUPS UUPP P PPP  SU,
  UPPSPPPP PPPP P DPR PPP,
 UPPPPPPPP   PP P  PR  DD,
 PDPRPPPPP    PS P PR  S ,
 S    PPPP LPRLP   PR LP ,
PP  U    P  D LP  UPR LP ,
PPU P  U PU S  PPPPP U P ,
PPPUPSLP  PPPR    DPPPPP ,
E  PPPPPP  PP  U    D    ,
PU     DPR PP  P  U      ,
PP   UU S  PP  PS P S UUU,
PPPPUPPPPPPPP PPPPPPPPPPP